10
G.G.-.B.P.B.-.-.-.-
G.G.S.B.P.B.-.-.G.-
-.BS.W.BSG.P.B.-.-.-.-
B.P.BS.-.B.-.G.-.-.-
P.B.-.-.-.-.-.-.-.-
B.-.-.-.-.-.GB.-.-.-
-.-.-.G.-.B.P.B.-.-
-.G.G.-.-.-.B.-.B.-
-.G.G.-.-.-.-.B.P.B
G.-.-.-.-.-.-.-.B.-