10
-.B.P.B.-.G.-.G.-.G
-.-.B.-.-.-.-.-.G.-
-.B.P.B.-.-.-.G.-.-
B.P.B.-.-.-.G.-.-.-
-.B.-.B.-.-.S.-.-.-
-.G.B.P.B.S.W.S.-.-
G.G.-.B.-.-.S.G.B.-
-.-.G.G.-.-.-.B.P.B
-.G.G.G.G.-.B.P.B.-
G.G.G.G.G.G.-.BG.G.G